适合=[shìhé] qualify,conform,fit,go,befit,quadrate,will,accord,tailor,beseem,serve,comport,gee,answer,become,fit_in,service,pertain,like,accommodate,agree,belong,characterize,make,suit,match
问题=[wèntí] problem,mishap,query,job,interface,question,inquiry,matter,enquiry,trouble,issue,worry,subject,topic,hang-up,business,quaere
参与=[cānyū] participate in
对于=[duìyū] (in regard) to,toward,at,for
开放=[kāifàng] lift a ban/etc.,be turned on,be in operation
开放=[kāifàng] open to the world,open to traffic or public use
终于=[zhōngyū] in the last analysis,at long last,at last,lastly,ultimately,all things considered,out,on the whole,at_last,eventually,in the final analysis,finally
课程=[kèchéng] course of instruction,lesson,course,course of lectures,course of study,curricular,class,curricula,syllabus,curriculum,program
推动=[tuīdòng] push forward,promote
变化=[biànhuà] change,transformation
出现=[chūxiàn] appear,arise,emerge
效果=[xiàoguǒ] operation,execution,result,effect,background,sound effects,purpose,point,background signal,fruitage,outcome,force,punch
公共=[gōnggòng] common,commonly,publicly,public,communal
形成=[xíngchéng] take shape,form
取得=[qǔdé] gain,acquire,obtain
形式=[xíngshì] circumstance,form,kind,modality,reading,interpretation,variety,shape,embodiment,species,mode,version,sort
参与=[cānyū] participate in
中央=[zhōngyāng] central authorities (of state/party/etc.)
老人=[lǎorén] oldster,ancient,old woman,crock,one's aged parents or grandparents,old man/woman,one's aged parents/grandparents,Sir,old person,gaffer,pop,one's aged parents,the aged/old,old_man,senior_citizen,oldie,greybeard,old man,graybeard,old,grandparents,the old,the aged,senior citizen,old_boy,old boy,woman,old-timer,old man or woman,one's aged grandparents
儿子=[érzi] viscount,man-child,boy,male offspring,son
女性=[nǔxìng] lady,female sex,womankind,feminie,female,sex,petticoat,femininity,female person,woman,she,patroness,womanhood,fair,feminine
这里=[zhèlǐ] this place,there,here
公尺=[gōngchǐ] m.[standard]
积极=[jījí] positive,active,energetic,vigorous
健康=[jiànkāng] healthy,sound
讨论=[tǎolùn] to discuss,to take something up with someone,to talk about
总统=[zǒngtǒng] president (of a republic)
认识=[rènshì] know,recognize
彼此=[bǐcǐ] each other,one another,I/me too
清楚=[qīngchǔ] clear
参加=[cānjiā] join,attend,take part in,give (advice/etc.)
功能=[gōngnéng] functional,niche,function,competence,capacity,anatomy
完全=[wánquán] completely,fully,wholly,absolutely
结构=[jiégòu] constitution,configuration,framing,structural,design,underframe,framework,construction,structure,schematism,economy,fabric,mechanics,composition,machinery,contexture,texture,constellation,fable,ordonnance,skeleton,organization,frame,architecture,chemistry,make
经营=[jīngyíng] manage,run,engage in
孩子=[háizi] kid,issue,chap,daughter,children,sonny,son or daughter,child,spawn,boy,kipper,son
专家=[zhuānjiā] guru,pundit,adept,expertise,professional person,specializer,specialist,proficient,whiz,oner,expert,swami,savant,dab,professional,authority,stunner,technician
处理=[chǔlǐ] handle,deal with,dispose of,process
实际=[shíjì] practical,literal
根据=[gēnjù] on the basis of,according to
网路=[wǎnglù] WWW,net,network,Internet,meshwork,web,world wide web,mesh,reticulation
包括=[bāokuò] consist_of,consist of,subtend,embrace,comprise,incorporate,embody,involve,count,subsume,take_in,comprehend,incorporation,include,comprize,run,cover,package,consist in
显示=[xiǎnshì] demonstrate,argue,exhibit,prove,display,show,illustrate,manifest,demonstration,announce,stamp,unroll,witness,write,give,evince,dangle,betray,bespeak,say,profess,develop,indicate,signal,flaunt,read,register,manifestation,speak,reveal,evidence,tell,shew,proclaim,discover,stage,bear,establish,record,prognosticate,betoken,note,signalize
之后=[zhīhòu] later,behind,at the back of,after
母亲=[mǔqīn] venter,materfamilias,mother,mither,sultana,maternal,female parent,mater
媒体=[méitǐ] mass media,media,medium
合作=[hézuò] cooperate,collaborate,work together
安全=[ānquán] safe,secure
许多=[xǔduō] lot,scores,lots,sight,pot,heap,quantity,plenty,slews,ton,battalion,many,scads,tidy sum,power,spate,chunk,pile,crowd,vastness,batch,lashings,whole lot,mint,mound,pocketful,large number,trunkful,ream,mickle,great deal,flock,mass,slew,heaps,a lot of,piles,whole slew,mess,raff,slue,gobs,much,lotta,multitude,volume,wad,store,raft,tons,satiety,rafts,doze
家庭=[jiātíng] hearthstone,background,fireside,establishment,household,hearth,domestic,hearthside,menage,home,family unit,family,house
指出=[zhǐchū] point,point_out,catch_out,bespeak,indicate,denote,point out (that),note,show,designate,point out
比较=[bǐjiǎo] relatively,fairly
节目=[jiémù] item,item (on program),programme,act,telecast,number,program
服务=[fúwù] be in the service of,serve
运用=[yùnyòng] utilize,wield,apply
如何=[rúhé] how
智慧=[zhìhuì] lore,sapiency,sconce,wit,intelligence,gumption,savvy,wiseness,soundness,wisdom,grey_matter,sapience
不断=[búduàn] unceasingly, continuously
进一步=[jìnyībù] go step further
只好=[zhǐhǎo] can only,have no choice but,have to,be forced to
感到=[gǎndào] feel,sense
即使=[jíshǐ] conj.: even, even if/though
特色=[tèsè] motif,a character,a characteristic,manner,trait,differentiation,flavor,colour,singularity,distinction,characteristic,hue,stripe,physiognomy,a distinguishing feature,idiom,specialty,character,difference,particular,distinguishing feature,distinguishing feature/quality,salience,coloration,distinguishing quality,specific,feature,peculiarity,artistic st
鼓励=[gǔlì] encourage,urge
否则=[fǒuzé] conj.: otherwise,if not,or else
是否=[shìfǒu] whether or not,is it so or not
方面=[fāngmiàn] side,aspect,sector,part,light,facet,behalf,way,respect,direction,bearing,field,phase,sphere,angle,hand
现象=[xiànxiàng] phenomenon,phenomenal,appearance
存在=[cúnzài] exist,be
任何=[rènhé] aught,det.: any
规定=[guīdìng] rules,disciplines,regulations
透过=[tòuguò] via
人生=[rénshēng] lifetime,life,lifespan,human life,time of life
事业=[shìyè] proposition,task,pidgin,institution,undertaking,deed,facilities,life history,endeavour,endeavor,cause,career,project,action,enterprise
建立=[jiànlì] establish,set up,found
由于=[yóuyū] conj.: owing/due/thanks to
重要=[zhòngyào] important,significant,major
附近=[fùjìn] neighborship,neighborhood,precinct,vicinity,neighbourhood
有的=[yǒude] det : some
行政=[xíngzhèng] administration
考虑=[kǎolù] think over,consider
增加=[zēngjiā] increase,raise,add
大概=[dàgài] chiefly,if not,perchance,approximately,believably,maybe,presumably,plausibly,almost,conceivably,most likely,assumedly,ablings,likely,perhaps,probably,supposedly,ablins,credibly,assumably,belike
传统=[chuántǒng] rule,patrimony,legacy,custom,heritage,convention,conventionality,routine,normal practice,common practice,tradition
成绩=[chéngjī] execution,carrying into action,achievement,result,showing,carrying out,performance,grade,success,doing,batting average
严重=[yánzhòng] serious,significant,acute,critical,severe,grave
并且=[bìngqiě] conj.: and,besides,moreover
市场=[shìchǎng] bourse,bazar,marketplace,grocery store,agora,bazaar,securities industry,grocery,piazza,plaza,rialto,mart,pitch,market
利用=[lìyòng] use,utilize,take advantage of,exploit
美丽=[měilì] beautiful
执行=[zhíxíng] carry out,execute
引起=[yǐnqǐ] elicit,beget,causation,give rise to,incite,pique,engender,bring_on,trigger,fire,compel,kick_up,superindividual,draw,spawn,invite,touch_off,occasion,lead,bring_about,procure,touch off,raise,enkindle,give,poke,produce,capture,generate,stir,arouse,excite,put forward,provoke,breed,bring,conjure up,grip,create,kindle,tempt,set_up,interest,give rise,enga
直接=[zhíjiē] direct,immediate
空间=[kōngjiān] elbow room,allowance,margin,roomage,open air/sky/space,road,leeway,way,open air,sheets,room,tolerance,opening,clear,sky,spacial,interspace,vacuity,spatial,dimension,open sky/space,space,place,vacuum
生产=[shēngchǎn] produce,manufacture
不错=[búcuò] not bad,pretty good;correct,right
时间=[shíjiān] moment,day,clock time,fourth_dimension,relativity,hour,duration,time,when,while,temporal,economy
永远=[yǒngyuǎn] e'er,always,for_good,evermore,ever,forever
拥有=[yǒngyǒu] occupy,have,receive,aught,hold back,keep,keep back,owe,retain,own,possess,possession,hold,seize,take,acquire,corral,hold on
双方=[shuāngfāng] both,the two parties,two parties,both sides
会议=[huìyì] synod,moot,conference,board,convocation,soviet,congress,talks,indaba,negotiation,junta,group discussion,convention,meeting place,session,council,rendezvous,colloquy,coming together,powwow,seance,meeting,forum,consultation,roll-up,get-together,assembly
品质=[pǐnzhí] calibre,appraisal,caliber,character,self,intrinsic,brew,quality,timber,sort
年轻=[niánqīng] junior,young
委员会=[wěiyuánhuì] board,soviet,commission,committee,court,citizens committee,mission,delegacy,deputation,delegation,council
从事=[cóngshì] engross,have,join,treat,plow,handle,follow,embark,undertake,attend_to,attack,occupy,absorb,go_into,work,engage,prosecute,go_about,go in for,pursue,be,meddle,embark_on,perform,enter,cover,deal,address,be engaged in,deal with,place,wage
业者=[yèzhě] dealer,interest
仍然=[réngrán] still,yet
举办=[jǔbàn] conduct,hold,run
回来=[huílái] come back,get_back,recur,revisit,come,return,be back,come_back
的话=[dehuà] conj.: if
控制=[kòngzhì] control,dominate,command
人类=[rénlèi] man,wight,human_being,human,human race,mankind,individual,human species,Homo_sapiens,populace,creature,hominid,world,mortality,microcosm,humans,humanitarianism,humanity,humanness,human beings/species,people,species,humankind,human beings,public,mortal
发生=[fāshēng] happen,occur,take place
经费=[jīngfèi] finances,monetary resource,expenses,expense,expenditure,pecuniary resource,fund,outlay,funds,outgo,cash in hand
增加=[zēngjiā] increase,raise,add
所有=[suǒyǒu] det.: all
行为=[xíngwéi] fact,demeanor,form,deportment,dealing,behavior,doings,course,act,point,goings-on,demeanour,procedure,lapse,going,bearing,turn,behaviour,activity,ongoing,thing,human action,conduct,commitment,human activity,behavioral,agency,deed,comportment,action
觉得=[juéde] imagine,guess,believe,reckon,suspect,suppose,think,listen,feel,consider,think_of,appear,conceive
成长=[chéngzhǎng] grow up,mature
高兴=[gāoxìng] glad, happy, cheerful, merry, pleased
重视=[zhòngshì] attach importance to,take sth. seriously,value
正在=[zhèngzài] course of,be,be in process
希望=[xīwàng] hope,wish
提出=[tíchū] put forward,pose,raise
工作=[gōngzuò] work,job
意见=[yìjiàn] latitude,point_of_view,estimation,sight,conceit,verdict,hypothesis,attitude,estimate,possibility,judgement,appraisal,ground,slant,differing opinion,ruling,complaint,thinking,suggestion,comment,advisement,mind,apprehension,say,vote,impression,deliverance,view,understanding,feeling,idea,notion,sentiment,judgment,advice,current,opinion,advert,theory,v
原因=[yuányīn] origin,causation,reason,wherefore,causal,breeder,spore,cause,causal agent,whence,causal agency,occasion,root,subject,causality,why,starter
就是=[jiùshì] conj.: even if,even
决定=[juédìng] decide,resolve,make up one's mind,determine
机会=[jīhuì] scouth,occasion,good luck,hap,liberty,fortune,opportunity,chance,joss,hazard,happy chance,probability,luck,scope,room,break,turn,opening
考虑=[kǎolù] think over,consider
电脑=[diànnǎo] electronic computer,computery,data processor,information processing system,computer
兴趣=[xìngqù] relish,appetite,zestfulness,dish,cup of tea,pastime,hobby,interest,gusto,bag,avocation,zest
老师=[lǎoshī] rabbi,professor,swami,instructor,teacher,mast
部分=[bùfèn] partial,department,section,partialness,slice,pars,part,det.: part,percent,partage,sphere,component,divvy,segment,portion,fraction,sector,chapter,share,percentage,piece,division,sectional,parcel
比赛=[bǐsài] match,competition
范围=[fànwéi] demesne,latitude,shot,compass,extensity,panorama,parameter,boundary,arena,stretch,territory,radius,spectrum,scope,extension,sphere,orbit,circumscription,limits,purview,grasp,extent,region,space,limit,hemisphere,horizon,envelope,bounds,realm,terrain,tether,sphere of influence,range,circuit,domain,precinct,reach,area,length,spread,bailiwick,ambit,con
影响=[yǐngxiǎng] influence
人们=[rénmen] workforce,hands,work force,folk,people,they,the people,men,manpower,common people
专业=[zhuānyè] professional
研究所=[yánjiùsuǒ] graduate_school,research institute,school,laboratory,graduate school,institute
民众=[mínzhòng] civil,crowd,masses,populace,rank_and_file,the masses,the masses of the people,the populace,demos,mob,multitude,plebs,commons,the common people,the people,million,public
生活=[shēnghuó] life,existence,livelihood
根本=[gēnběn] at all,utterly
事情=[shìqíng] proposition,pie,shebang,thing,affair,occasions,undertaking,concern,question,business,schmear,matter
美丽=[měilì] beautiful
人员=[rényuán] strength,personnel,force,staff
高兴=[gāoxìng] glad, happy, cheerful, merry, pleased
开始=[kāishǐ] begin,start
喜欢=[xǐhuān] like,love,be fond of,be happy/elated
实施=[shíshī] put into effect,implement
非常=[fēicháng] extraordinary,unusual,special,very,extremely,highly
申请=[shēnqǐng] apply for
讨论=[tǎolùn] to discuss,to take something up with someone,to talk about
维持=[wéichí] keep,preserve
感情=[gǎnqíng] warmheartedness,reticence,sensation,affection,susceptibility,feeling,feelings,heart,affective,withers,expression,tenderness,emotion,sentiment,fondness,soul,affectionateness,soulfulness,passion
愿意=[yuànyì] will,be willing,please,wish,like,care
工具=[gōngjù] stock-in-trade,instrumentality,instrument,ministry,hand_tool,escalator,creature,utensil,material,gear,pawn,lobster-joint,cat's-paw,kit,apparatus,tool,appurtenances,paraphernalia,means,wood,tackle,implement,medium,lever,outfit
土地=[tǔdì] country,acre,terra,soil,premise,realm,territory,dirt,local god of the land,farming,earth,ground,kingdom,holding,agrarian,solid ground,benefice,esplees,tract,village god,glebe,terra firma,land,dry land
目的=[mùdì] view,pretence,objective,goal,purport,intention,bourn,object,motive,motivation,meaning,aim,end point,hent,target,scope,sense of purpose,errand,purposefulness,sake,function,end,purpose,quaesitum,intent
价格=[jiàgé] price
建筑=[jiànzhù] building,structure,edifice,architecture
至于=[zhìyū] as for/to
注意=[zhùyì] pay attention to,take note of
前往=[qiánwǎng] depart,cruise,go_to,go,leave,go to,proceed to,pay,seek,leave for
共同=[gòngtóng] common,joint
研究=[yánjiù] study,research
我国=[wǒguó] our country
影响=[yǐngxiǎng] influence,affect,effect
因此=[yīncǐ] conj.: therefore,consequently
受到=[shòudào] experience,receive,come in for,suffer,undergo,come_in_for,be given,come_to,be subjected to
发展=[fāzhǎn] develop,expand,grow
自然=[zìrán] natural world
而是=[érshì] conj.: if not A, then B
丰富=[fēngfù] rich,abundant,plentiful
必须=[bìxū] must
当地=[dāngdì] locality,the place (named/mentioned/etc.)
自然=[zìrán] naturally,of course,in ordinary course of events
人士=[rénshì] public figure,personage
全球=[quánqiú] global,whole world
利用=[lìyòng] use,utilize,take advantage of,exploit
安排=[ānpái] arrange,plan,fix up,provide (meals/etc.)
等等=[děngděng] conj.: and so on,etc
处理=[chǔlǐ] handle,deal with,dispose of,process
合作=[hézuò] cooperate,collaborate,work together
怎么=[zěnme] how
结束=[jiéshù] end,close,conclude
他们=[tāmen] they
大家=[dàjiā] sundry,great master,rich and influential family,pontiff,all of us,everyone,authority,master,distinguished family
分析=[fēnxī] analyze
生产=[shēngchǎn] produce,manufacture
减少=[jiǎnshǎo] reduce,decrease
系列=[xìliè] succession,set,spectrum,course,train,series
意义=[yìyì] importance,significance,denotation,purport,drift,signality,emptiness,meaning,construction,bearing,substance,import,effect,insignificancy,hang,signification,sense
活动=[huódòng] activity,maneuver,behavior
自由=[zìyóu] free,unrestrained
软体=[ruǎntǐ] software
注意=[zhùyì] pay attention to,take note of
常常=[chángcháng] oftentimes,ofttimes,commonly,ordinarily,oft,often,a great deal,normally,frequently,unremarkably,much,usually
如果=[rúguǒ] conj.: if
配合=[pèihé] coordinate, cooperate
实际=[shíjì] practical,literal
取得=[qǔdé] gain,acquire,obtain
对象=[duìxiàng] boy/girl friend,mate,fair game,boy friend,prey,boy,object,quarry,target,girl friend,catch,match
多少=[duōshǎo] det.: how many,how much,many
听到=[tīngdào] hear
认为=[rènwéi] find,treat,deem,suppose,look_on,repute,discount,esteem,accredit,feel,account,calculate,estimate,take to be,reckon,expect,think,hold,trust,recognise,opine,sound off,adjudge,consideration,consider,regard as,look upon,believe_in,disbelieve,allow,conceive,regard,call,imagine,view,forecast,believe,suspect,rate,animadvert,look on,listen,speak up,figure,c
举行=[jǔxíng] hold (meeting/etc.)
大众=[dàzhòng] the broad masses,roughscuff,the public,herd,concourse,commonality,riffraff,masses,commonness,the masses,throng,multitude,commonage,commonalty,plebeian,plebs,horde,the people/masses,community,the people,million,mass,public
国外=[guówài] overseas
经验=[jīngyàn] experience
家长=[jiāzhǎng] masterman,housemaster,graybeard,patriarch,parent of schoolchildren,patriarchal,goodman,patriarchate,paterfamilias,the head of a family,genearch,patriarchy,householder,head of household,the parent or guadian of a child
设计=[shèjì] design,plan
进行=[jìnxíng] be in progress,go on,carry on/out
业务=[yèwù] service,practice,vocational work,line of work,affair,line,occupation,professional work,business,transaction
简单=[jiǎndān] terse,casual,commonplace,simple,oversimplified,ordinary,uncomplicated
领域=[lǐngyū] demesne,line of business,field of operation,country,background,terrain,realm,part,arena,sphere of influence,setting,territory,precinct,radius,scope,domain,sphere,frontier,orbit,preserve,area,world,kingdom,ambit,signory,province,region,field,universe,hemisphere
女人=[nǔrén] jade,crumpet,female,female person,Gill,bitch,chick,fair,squaw,womenfolk,adult female,doll,momma,wench,skirt,womankind,girl,jill,wife,broad,petticoat,sister,woman,bimbo,bird,jane,she,hen,hairpin,dame,women
但是=[dànshì] conj.: but,however,yet,still
除了=[chúle] except,besides
单位=[dānwèi] department,unit,denomination,module,building block,unit of measurement,monad,unit (in measurement or organization)
电话=[diànhuà] blower,phone call,headphone,earpiece,telephone,telephone_call,buzz,earphone,horn,telephone set,phone_call,telephony,phone
相当=[xiāngdāng] quite,fairly,considerably
国民党=[guómíndǎng] Kuomintang,Nationalist Party,Kuomintang (KMT)
追求=[zhuīqiú] seek, pursue, woo, court
结束=[jiéshù] end,close,conclude
人才=[réncái] talent,capable person,a talented person,qualified personnel,a person of ability
推动=[tuīdòng] push forward,promote
成立=[chénglì] found,establish,be tenable,hold water
中心=[zhōngxīn] center,heart,hub
政治=[zhèngzhì] paternalism,trouble,government,policy,political relation,political science,polity,politics,political affairs,political
主任=[zhǔrèn] head,principal,captain,chair,director,head teacher,chief,chairman,school principal
程式=[chéngshì] formula,instruction,computer programme,pattern,form,modality,subprogram,routine,programme,course,function,subroutine,procedure,mode,order,sequence,computer program,program
真正=[zhēnzhèng] true,indeed,certainty
电影=[diànyǐng] cinematography,moving_picture,pix,kinema,picture,film,movie,moving picture,flick,cinema,motion_picture,cinematic,celluloid,picture show,motion picture,flicker
爸爸=[bàbà] old man,father,papa,pappa,daddy,pa,begetter,pop,dada,dad,male parent,pater,pappy,pops,poppa
能够=[nénggòu] can,able,would,may
教师=[jiàoshī] beak,don,school teacher,schoolman,teacher,schoolmaster,preceptor,professor,pedagogue,schoolteacher,coach,master,instructor,educator,preceptorship
故事=[gùshì] spiel,recital,relation,scam,rede,plot,yarn,narration,story,fiction,tale,history,legend,narrative
管理=[guǎnlǐ] manage,supervise,take care of
改善=[gǎishàn] improve,perfect
建设=[jiànshè] construction
来自=[láizì] come from,originate from,come,stem/originate from,attach_to,stem,come/stem/originate from,hail
不足=[bùzú] not be enough,not be worth (doing sth.),cannot,should not
开放=[kāifàng] lift a ban/etc.,be turned on,be in operation
获得=[huòdé] find,cop,acquirement,come_into,gain,draw,pick_up,pull,achievement,score,procure,come_by,get hold,purchase,nab,come upon,derive,latch,incur,achieve,make,bring,receive,arrive,come_out,pocket,obtain,luck into,sack,win,enter upon,pick up,garner,harvest,attain,come up,line up,extract,secure,possess,earn,reap,accrue,cover,take,acquire,get,arrive_at
组织=[zǔzhī] tissue,nerve,weave,organization,organized system
状况=[zhuàngkuàng] repair,background,picture,state (of affairs),state of affairs,status,gear,scene,setting,scope,condition,state,circumstance,trimness,context,showing,trim,factor,condition/state (of affairs),situation,shoes,consideration,place
因素=[yīnsù] consideration,ingredient,constituent,factor,strand,component,element
时候=[shíhòu] day,moment,(a point in) time,(duration of) time,time
里面=[lǐmiàn] inside,interior
为什么=[wèishéme] why,why?,how come,why is it that?,whereat,whereto
运动=[yùndòng] sports,athletics,exercise,movement,campaign
同样=[tóngyàng] same,equal,similar
经常=[jīngcháng] everyday,daily,alway,often,a great deal,frequently,sempre,much,regularly,constantly,evermore,day-to-day
协助=[xiézhù] assist,help
明显=[míngxiǎn] clear,obvious
主要=[zhǔyào] main,chief,principal,major
之下=[zhīxià] under the condition of,under,beneath,below
结果=[jiéguǒ] result,outcome,consequence
学校=[xuéxiào] seminary,schoolhouse,educational institution,school,institution
程度=[chéngdù] latitude,rate,degree,point,measure,way,grade,gree,pitch,cut,length,plane,stage,level,extent,scale,notch
容易=[róngyì] easy
以后=[yǐhòu] afterwards,later,future,in the future,hereafter
一点=[yīdiǎn] det.: a little bit
心理=[xīnlǐ] mental_state,psychology,mentality
积极=[jījí] positive,active,energetic,vigorous
达到=[dádào] extend to,find,fulfil,compass,encompass,extend,gain,answer,achievement,succeed,fulfill,live_up_to,attainment,strain,bring_up,achieve,get to,touch,strive,make,accomplish,progress to,come,hit,come_out,obtain,reach,attain,clock_up,suffice,do,get,arrive_at
情况=[qíngkuàng] event,things,state of affairs,circumstantiality,case,circumstances,way,plight,experimental condition,streak,military situation,matter,condition,mood,circumstance,context,occasion,thing,instance,affair,shape,situation,juncture,consideration
社区=[shèqū] community
国内=[guónèi] interior (of country),interior,home,intestine,internal,domestic
妇女=[fùnǔ] feme,womankind,female,femininity,cummer,woman,femme,quean,bevy,matron,toots,womanhood,feminine,womenfolk,women
父母=[fùmǔ] parental,parents,father and mother,folks
不但=[búdàn] conj.: not only
可以=[kěyǐ] can,may
规划=[guīhuà] plan,program
成功=[chénggōng] succeed
重视=[zhòngshì] attach importance to,take sth. seriously,value
自我=[zìwǒ] self,oneself
其他=[qítā] det.: others,the rest,other,else
意识=[yìshì] consciousness,witting,sensibility,conscious,conscience,ideology,awareness,subconscious,mentality
员工=[yuángōng] employee,personnel,reason,force,staff,cause
很多=[hěnduō] det.:
正式=[zhèngshì] formal (of actions/speeches/etc.)
儿童=[értóng] kid,nipper,enfant,tyke,youngster,small fry,minor,shaver,nestling,tike,child,chit,fry,children,infant,tiddler,small-fry
加入=[jiārù] join,accede to
这些=[zhèxiē] det.: these
改变=[gǎibiàn] change,transform
中共=[zhōnggòng] Chinese Communist Party
政策=[zhèngcè] statism,tack,line,policy,statecraft
阶段=[jiēduàn] staged,period,phase angle,stage,gradation,level,peg,grade,remove,phase,leg,step
减少=[jiǎnshǎo] reduce,decrease
新闻=[xīnwén] unco,leak,intelligence,newsworthiness,witting,journalistic,information,journalism,courant,news
产生=[chǎnshēng] come into being,produce,engender,emerge
角色=[jiǎosè] theatrical role,character,persona,part,function,office,fictional character,actor,fictitious character,personage,role
压力=[yālì] force per unit area,P,strain,overwhelming force,pressure sensation,burdensomeness,oppressiveness,pressure,onerousness,stress,compulsion,constraint,muscle,lading
其实=[qíshí] as a matter of fact,actually,in fact
努力=[nǔlì] make great effort,try hard
厂商=[chǎngshāng] factory owner,factories and stores,firm,maker,business organization,business concern,manufacturing business,concern,manufacturer,business
投资=[tóuzī] investment
表示=[biǎoshì] demonstrate,exhibit,prove,show,extend,manifest,express,stamp,signify,mark,witness,look,give,denote,evince,expression,bespeak,say,profess,mean,offer,utter,infer,indicate,represent,read,speak,refer,give tongue to,intend,be,shew,pay,stand_for,establish,stand for,present,render,betoken
属于=[shǔyū] fall under,be part of,pertain,appertain,belong,relegate,fall into,belong_to,fall_under,reside,belong to,attach
分别=[fēnbié] separately,respectively
不能=[bùnéng] must/may/can not,not be allowed
欢迎=[huānyíng] invite,greet,take in,receive,welcome,gratulate,embrace,salute
通过=[tōngguò] adopt,pass,carry (motion/legislation)
成为=[chéngwéi] find,join,comprise,turn to,commemorate,sample,entomb,come_up,commence,get hold,learn,add up,necessitate,run,make up,constitute,make,form,come,amount,represent,fall,presage,change,be,turn,turn into,become,line up,come up,shape,portend,foretell,get
了解=[liǎojiě] understand,comprehend,find out,acquaint oneself with
国家=[guójiā] sirkar,state,country,patria,a people,nationality,nation,republic,soli,body politic,clime,national,civil order,polity,commonwealth,land,res publica
变成=[biànchéng] grow_into,change into,go,form,grow into,change state,develop into,turn to,fall,turn_into,be,turn,become,turn into,grow,run,get
控制=[kòngzhì] control,dominate,command
系统=[xìtǒng] lineage,filiation,scheme,pedigree,system,formation,superstructure,programme,organization,succession,tract,system of rules,organisation,program
思考=[sīkǎo] ponder over,reflect on
资讯=[zīxùn] stuff,message,information,news,info
我们=[wǒmen] we
那些=[nǎxiē] det.: those
自己=[zìjǐ] lonesome,number_one,own,ego,self,oneself,name
责任=[zérèn] need,care,encumbrance,buck,accountability,blame,obligation,turn,load,responsibleness,incumbrance,responsibility,onus,commission,burden,commitment,loading,trust,pigeon,charge,business,fault,place,liability,duty,guardianship
存在=[cúnzài] exist,be
教学=[jiāoxué] teach and study
身体=[shēntǐ] soma,system,physical structure,body,health,carcase,corpus,frame,person,somatic,organic structure,personage
经过=[jīngguò] pass,go through,undergo
一起=[yīqǐ] in_chorus,together,in all,in the same place,holus-bolus,altogether,in company
发挥=[fāhuī] bring into play,give free rein to,develop (idea/etc.),elaborate
没有=[méiyǒu] not have,there is not,be without
美国=[měiguó] House_of_Representatives,the United States of America,US,U.S.A.,bench,Columbia,Yankeeland,U.S.,United States,Democrat,Yankeedom,USA,America,United States of America
办法=[bànfǎ] road,expedient,policy,agency,measure,way,method,means
事实=[shìshí] mood,circumstance,fact,factual,reality,verity,case,deed,sooth,troth,actuality,truth,matter,matter of fact
对方=[duìfāng] other party,the other party,fellow,party,other side,adversary,other side/party
回到=[huídào] remount,retour,recur,turn back,regress,regain,revert,go_back,return to,return,go back to
团体=[tuántǐ] fraternity,sect,phalanx,collective,body,group,sodality,element,organisation,corporation,confession,college,establishment,brotherhood,community,organization,squad,union,administration,society,army,commonwealth,consort,company,lineup,combine,governance,clan,combination,fellowship,organizational,bloc,team,party,connection,family,brass,squadron
研究=[yánjiù] research,study
保护=[bǎohù] protect,safeguard
不仅=[bùjǐn] conj.: not only
日本=[rìběn] Nippon,Cipango,Nihon,Japan,japan,Japanese
此外=[cǐwài] conj.: besides,in addition,moreover
往往=[wǎngwǎng] oftentimes,ofttimes,always,more often than not,frequently,oft,often
成立=[chénglì] found,establish,be tenable,hold water
沟通=[gōutōng] communicate,link up
推出=[tuīchū] present to public
计画=[jìhuà] plan,project,program
电子=[diànzǐ] electron
曾经=[céngjīng] in one case,,one time,formerly,syne,at one time,of all time,once,ever
不必=[búbì] need not,not have to
调查=[diàochá] investigate,look into,survey
加强=[jiāqiáng] strengthen,augment,reinforce
使用=[shǐyòng] use,employ,apply
开始=[kāishǐ] begin,start
怎么样=[zěnmeyàng] How are things?
记者=[jìzhě] journalist,writer,correspondent,newspaperwoman,newspaperman,gazetteer,newswriter,reporter,pressman,newshound,newsman,newsperson
使得=[shǐdé] render,wreck,compel,cause,make
实施=[shíshī] put into effect,implement
告诉=[gàosù] tell,preach,notify,impart,inform,represent,apprize,send word,share,advise,give notice,apprise,assure,let know
肯定=[kěndìng] affirm,approve,regard as positive
苏联=[sūlián] Russia,Soviet,USSR,Soviet Union
快乐=[kuàilè] happy,cheerful
担任=[dānrèn] hold the post of,take charge of,assume,take_charge,fill,shoulder,adopt,skipper,assume the office of,assume office of,act_as,take,act as,play,undertake,take over,take on
技术=[jìshù] mechanics,know-how,prowess,science,Minerva,superior skill,art,competence,technology,craft,craftsmanship,skill,education,technique,artistry,engineering,technological,equipment,technical
声音=[shēngyīn] voice,vocal,language,huskiness,vox,vocalization,audio,noise,sonic,tone,sound,phone,audio frequency
保护=[bǎohù] protect,safeguard
观察=[guānchá] observe,survey,inspect
实在=[shízài] indeed,really,honestly,in fact,as a matter of fact
反而=[fǎnér] conj.: on the contrary, instead
配合=[pèihé] coordinate, cooperate
几乎=[jīhū] chiefly,anear,about,near,just_about,most,well-nigh,almost,closely,practically,intimately,all but,nearly,just about,virtually,much,nigh
台湾=[táiwān] Taiwan
医院=[yīyuàn] spital,hospital,infirmary,hospice
带来=[dàilái] bring,redound,impart,bring_on,bring on,express,fetch,lend,convey,contribute,bring about,bestow,carry,bring oneself,add,usher,incur,land
成长=[chéngzhǎng] grow up,mature
不要=[búyào] never,noway,don't want,don't (do sth.)
以为=[yǐwéi] imagine,think/believe/consider erroneously,treat,deem,believe,suspect,suppose,consider erroneously,repute,animadvert,esteem,trow,speak up,feel,count,believe/consider erroneously,calculate,view as,guess,ween,look,expect,think erroneously,think,hold,opine,interpret,sound off,take_for,consider,take for
要求=[yāoqiú] request,demand
态度=[tàidù] stance,treatment,demeanor,dealing,deportment,pose,behavior,manner,demeanour,way,bearing,attitude,air,behaviour,front,mien,conduct,mental attitude,approach,posture,address,position,bedside_manner,movement,gesture,comportment,presence,sort
调查=[diàochá] investigate,look into,survey
世界=[shìjiè] mundane,creation,world,monde,orb,nature,domain
制作=[zhìzuò] make,manufacture
只要=[zhǐyào] conj.: so long as,provided
计划=[jìhuà] plan,project,program
这样子=[zhèyàngzi] so,such,like this,this way
官员=[guānyuán] beg,official,mandarinate,administrative official,office-bearer,officer,bureaucrat,placeman,federal agent,government officials,agent,officialism,functionary,director,officeholder,officialdom,myrmidon
大量=[dàliàng] det.: any numer of, a great many
地区=[dìqū] section,country,area,latitude,zone,terrain,parts,locality,sector,province,prefecture,region,district,faubourg
创造=[chuàngzào] create,produce,bring about
需求=[xūqiú] need,requisition,demand,want,desiderative,requirement,call
情形=[qíngxíng] circumstance,trimness,event,trim,instance,state of affairs,case,circumstances,status,situation,condition
具有=[jùyǒu] be provided with,have,have got,possess,hold,possession,carry,inhere,bear
开发=[kāifā] develop,open up,exploit
作品=[zuòpǐn] writing,musical composition,whole kit and caboodle,works (of literature,artwork,kit and caboodle,product,whole works,creation,full treatment,kit and boodle,whole kit and boodle,works (of literature/art),composition,thing,piece of music,workpiece,output,art),written material,opus,whole shebang,whole caboodle,production,whole kit,piece,workmanship,wo
价值=[jiàzhí] value,worth
思考=[sīkǎo] ponder over,reflect on
东西=[dōngxī] thing,creature
台北=[táiběi] capital of Nationalist China,capital of Republic of China on Taiwan,Taipei
解决=[jiějué] solve,resolve,settle,dispose of,finish off
中国人=[zhōngguórén] Chink,Chinee,Chinese,Chow,chow,John,a Chinese
大学=[dàxué] university,college
然后=[ránhòu] therewith,and so,and_then,and then,thereupon,after that,so,then,with that
运用=[yùnyòng] utilize,wield,apply
表达=[biǎodá] express,convey,voice
那么=[nàmo] so
思想=[sīxiǎng] cogitation,mentation,imagery,imaging,lunatic_fringe,mental imagery,idea,thinking,imagination,ideology,thought,pensee,ideological
加上=[jiāshàng] conj.: in addition (to)
先生=[xiānshēng] doctor of Chinese medicine,Don,mulla,Ms.,sir.,teacher,gentleman,gospodin,Signor,signor,fortune-teller,babu,baboo,Herr,Mister,bey,mister,bwana,husband,siree,buckra,sirrah,senor,guv,sahib,Mr.,rabbi,don,signore,Dan,sir,m'sieur,effendi,Tuan,baas,Monsieur,lording,monsieur,doctor,Mr,milord,Mynheer,signior,esquire,bookkeeper,Senor,rabboni,Senhor,sieur,sen
香港=[xiānggǎng] Hong Kong
男人=[nánrén] male,man,chap,mankind,buck,bastard,gentleman,jack,gent,men,blighter,cuss,hombre,lad,adult male,groom,husband,bimbo,dog,fellow,mon,menfolk,fella
提高=[tígāo] raise,heighten,enhance,increase,improve
也许=[yěxǔ] possibly,peradventure,conceivably,assumedly,mayhap,doubtless,ablings,perhaps,perchance,potentially,probably,maybe,presumably,ablins,just
不过=[búguò] conj.: but, however, only
看到=[kàndào] view,receive,ken,observe,lamp,catch,see,take in,watch,chatter away,lay_eyes_on,boast,brag,shoot the breeze,spy,catch sight of, catch sight of
主管=[zhǔguǎn] person in charge
人口=[rénkǒu] population
有关=[yǒuguān] be related
一般=[yībān] general,ordinary,common
不同=[bùtóng] different
制度=[zhìdù] ism,organization,dispensation,regimen,machine,regulations,form,system,regime,organisation,economy,institutional,institution
文化=[wénhuà] civilization,literacy,acculturation,Kultur,vandalism,cultural,education,schooling,culture
消费者=[xiāofèizhě] customer,buyer,consumer
公司=[gōngsī] place of business,business organization,incorporation,establishment,business concern,office,concern,business establishment,business,enterprise,company,corporation
沟通=[gōutōng] communicate,link up
因为=[yīnwèi] conj.: because,for,on account of
学生=[xuéshēng] academic,pupil,pup,tutee,follower,scholar,schoolchild,schoolboy,alumnus,disciple,learner,scholastic,student
事件=[shìjiàn] fact,event,page,incidental,go,case,job,natural event,timing,proceedings,social occasion,happening,occurrence,matter,occasion,incident,shebang,affair,chapter,concernment
健康=[jiànkāng] healthy,sound
北京=[běijīng] capital of Red China,Beijing,Peking,Beijing (Peking),Peiping
小孩=[xiǎohái] kid,tyke,encumbrance,kinchin,youngster,wean,small fry,chick,juvenile,imp,urchin,minor,nestling,prattler,tike,kiddie,tot,fry,bud,mammet,pinafore,nipper,enfant,mite,bairn,chicken,shaver,child,chit,kiddy,infant,tiddler,sprig
大陆=[dàlù] Ch. mainland
说明=[shuōmíng] explain,illustrate,show
经济=[jīngjì] economy,financial condition,income
期间=[qíjiān] length,period,time period,amount of time,duration,course,interim,period of time,time,standing,chapter,tract,space,term,streak,efflux
或者=[huòzhě] conj.: or,either...or...
学术=[xuéshù] ology,academic,systematic learning,science,learning
时代=[shídài] day,period,a period in one's life,epoch,present time,historical period,time,chapter,period in one's life,modern times,historic period,contemporary world,times,era,modern world,age
知识=[zhīshì] lear,know-how,understanding,ken,instruction,science,sophistication,consciousness,light,awareness,cognizance,knowledge,lore,mastery,know,cognition,acquaintanceship,mind,intellect,knowingness,equipment
可能=[kěnéng] probably,maybe
历史=[lìshǐ] past records,historical,history
另外=[lìngwài] conj.: in addition, besides, moreover
不管=[bùguǎn] conj.: no matter, regardless of
协助=[xiézhù] assist,help
校园=[xiàoyuán] schoolyard,campus
不少=[bùshǎo] det.: a lot of
只有=[zhǐyǒu] can only,have no choice but,to be forced to
生命=[shēngmìng] breath,god,head,anima,days,organism,blood,life,living thing,skin,longevity,being,vital,life form
设计=[shèjì] plan,design
发表=[fābiǎo] voice,enounce,enunciate,publish,free,sound,announce,pronounce,deliver,circulation,put_out,release,issue,vend,circularize,give,give_out,denote,present,circulate,publicize,blazon,promulgate,mouth
产业=[chǎnyè] estate,manufacture,industry,domain,manufacturing,property
过程=[guòchéng] unconscious process,mechanism,process,act,round,course
观察=[guānchá] observe,survey,inspect
快乐=[kuàilè] happy,cheerful
十分=[shífēn] very, fully, utterly, extremely
基本=[jīběn] fundamental,essential,main
作为=[zuòwéi] regard as,look on as,take for
谢谢=[xièxiè] thank
维持=[wéichí] keep,preserve
整体=[zhěngtǐ] integrity,allness,entirety,integer,integral,monolith,entireness,ensemble,wholeness,entire,tout ensemble,whole,totality,unity
缺乏=[quēfá] be short of, lack
重要=[zhòngyào] important,significant,major
针对=[zhēnduì] in the light of,in connection with
艺术=[yìshù] beaux-arts,aesthetical,artistic production,artistic,ars,art,academy,aesthetic,artistic creation,skill,craft,artistry,esthetic
成本=[chéngběn] cost
相信=[xiāngxìn] deem,believe,credit,esteem,accredit,feel,trow,count,have faith in,guess,lippen,buy,be convinced of,hold,think,trust,accept,know,hone,believe_in,favour,believe in,hope
尤其=[yóují] especially
之外=[zhīwài] beyond, apart from, excluding
形成=[xíngchéng] take shape,form
方式=[fāngshì] path,plan,pattern,tenor,system,method,manner,style,way,guise,fashion,wise,means,shape,how,embodiment,agency,gate,mode,sort
民间=[mínjiān] grass roots,people-to-people,nongovernmental,among the people,folk,popular
代表=[dàibiǎo] representative,delegate
产生=[chǎnshēng] come into being,produce,engender,emerge
接受=[jiēshòu] receive (honors,have,receive,acknowledge,sweep up,espouse,etc.),come to grips,adopt,embrace,greet,welcome,hook on,seize on,take up,accede,taken,entertain,latch on,buy,fasten on,swallow,imbibe,accept,receive (honors/etc.),undergo,get to grips,take,adapt,acceptance,thole
关系=[guānxì] relation,bearing,impact,membership credentials,"backdoor connections"
喜欢=[xǐhuān] like,love,be fond of,be happy/elated
企业=[qìyè] proposition,business enterprise,business organization,business concern,concern,commercial enterprise,endeavour,endeavor,industry,business,project,corporation,enterprise
完成=[wánchéng] fill in,finish out,fulfil,practice,complete,finish,encompass,clear_up,top_off,cleave,top off,accomplishment,make out,effect,perfective,fulfill,go through,exercise,discharge,fill out,completion,end,run,bring ... to fruition,round_out,achieve,execute,round out,make,cap off,accomplish,practise,follow through,come,finalize,fulfilment,dispatch,bring ...
管理=[guǎnlǐ] manage,supervise,take care of
为主=[wéizhǔ] give first place to
动物=[dòngwù] thing,critter,crittur,zoic,anthropomorphism,animal,deer,animate being,beast,creature,burrow,sire,worker,fauna,brute
建议=[jiànyì] propose,suggest,recommend
支持=[zhīchí] sustain,hold out,bear;support,back,stand by
机构=[jīgòu] internal structure of an organization,motion,gadget,instrumentality,institute,organ,mechanism,gear,representation,mechanics,machinery,apparatus,establishment,institution,means,organization,agency,setup,delegacy,outfit
方法=[fāngfǎ] know-how,plan,attack,system,stepping-stone,manner,method,gateway,idea,measure,way,guise,key,wise,quomodo,plan of attack,tack,machinery,process,avenue,modus,how,means,channel,gate,approach,agency,gamesmanship,mode,medium,sort
似乎=[sìhū] it seems,quasi,apparently,seemingly,as if
内容=[nèiróng] subject_matter,content,cognitive content,internal,contents,mental object,meat,substance,matter,lining
一定=[yīdìng] must
发挥=[fāhuī] bring into play,give free rein to,develop (idea/etc.),elaborate
如此=[rúcǐ] thus,like this,such
行动=[xíngdòng] action,operation
虽然=[suīrán] conj.: though,although
解决=[jiějué] solve,resolve,settle,dispose of,finish off
伊拉克=[yīlākè] Al-Iraq,Iraq,Irak
音乐=[yīnyuè] music
小时=[xiǎoshí] hour
加强=[jiāqiáng] strengthen,augment,reinforce
学习=[xuéxí] study,learn,emulate
开始=[kāishǐ] begin,start
之间=[zhījiān] among, between
开发=[kāifā] develop,open up,exploit
不足=[bùzú] not be enough,not be worth (doing sth.),cannot,should not
公园=[gōngyuán] common,green,garden,commons,park
朋友=[péngyǒu] amigo,connections,kith,friend,boy,crony,ami,boy/girl friend,companion,mate,boy friend or girl friend,compadre,boy friend,Mac,paisano,matey,old_boy,sport,folks,pard,hearty,Kamerad,cocker,cobber,girl friend,pardner,company
进入=[jìnrù] go_into,get_in,debouch,get in,go into,move into,come_into,pass,step_in,lapse,get_into,set in,go in,get into,kick in,penetrate,intromission,pierce,come_in,come in,enter,entry,sink,impenetrate
一些=[yīxiē] det.: some, a few, a little
还是=[háishì] still,nevertheless
之前=[zhīqián] before, prior to, ago
需要=[xūyào] need,want,require,demand
只是=[zhǐshì] merely,only,just,simply be
认识=[rènshì] know,recognize
主义=[zhǔyì] tenet,principle,hang,system,ticket,creed,philosophy,school of thought,evangel,ism,gospel,masonry,maxim,doctrine,-ism
以及=[yǐjí] conj.: as well as, along with, and
原则=[yuánzé] god,rule,formula,regulation,principle,fundamental,axiom,basis,linguistic rule,faith,principium
当然=[dāngrán] certainly,of course
避免=[bìmiǎn] forbear,preclude,refrain_from,forebear,escape,help,elude,leapfrog,refrain from,stave_off,evite,shun,obviate,avoid,evade,waive,help oneself,ward_off,ward,miss,avert,ward off,balk,refrain
小姐=[xiǎojiě] Signorina,Senorita,senorita,signorina,young_lady,damosel,Dona,mum,young lady,damoiselle,missy,tootsy,demoiselle,damsel,Miss,Fraulein,miss,sheila,sister,toots,senhorita,damozel,Ladyship,ladyship,Mademoiselle,mademoiselle
电视=[diànshì] TV,box,iconoscope,video,television set,teevee,orthicon,huckster,TV set,radiovision,television,telecasting,airwave,telly
有时=[yǒushí] now and then,at times,betweentimes,from time to time,sometimes
学习=[xuéxí] study,learn,emulate
教授=[jiàoshòu] professor
起来=[qǐlái] [aspect]
而已=[éryǐ] particle: imparting finality (that's all)
其中=[qízhōng] among,of them,in it,among them,which,them,det.: it,in,in which
推出=[tuīchū] present to public
资料=[zīliào] food,source,info,means,data,information,material,datum,data point,matter
训练=[xùnliàn] training
教育部=[jiàoyūbù] Education,Ministry of Education,Department of Education,Education Department
委员=[wěiyuán] commissar,committee man,committee,committee member,commissioner,committeeman,delegate,board member,commissary
工程=[gōngchéng] process,construction,engineering,engineering project,project
银行=[yínháng] jug,depository financial institution,bank building,banking company,banking concern,bank
服务=[fúwù] be in the service of,serve
教学=[jiāoxué] teach and study
结合=[jiéhé] combine,unite,integrate,link,be joined in wedlock
到底=[dàodǐ] to the end,at last,after all
地方=[dìfāng] country,soil,terrain,part,clime,way,territory,room,neighbourhood,tinderbox,locality (as distinct from the central administrat,child,tract,province,position,respect,where,region,space,place,local
环境=[huánjìng] circumambiency,environmental,circumstances,environment,entourage,surround,atmosphere,setting,surroundings,ambiance,condition,context,circumstance,surrounding,frame,milieu,ambient,consideration,environs,medium,ambience
应用=[yìngyòng] application,use
超过=[chāoguò] overpass,overreach,outwalk,outstrip,overstep,outmarch,distance,pass,overstride,outpace,overtop,surpass,crown,exceed,overtake,preponderate,overrun,top,outrun,go_over,transcend,outrange,transgress,go past,break,excess,overhaul,overshine
社会=[shèhuì] community,society,monde,social,public
好像=[hǎoxiàng] seem,be like
表现=[biǎoxiàn] manifestation,expression
支持=[zhīchí] sustain,hold out,bear;support,back,stand by
努力=[nǔlì] make great effort,try hard
采用=[cǎiyòng] invoke,admit,assume,adoptive,use,adopt,select for use,embrace,accept,employment,take,introduce,take up,take_on,take over,take on,borrow,employ,adoption
原来=[yuánlái] originally,formerly
台北市=[táiběishì] capital of Republic of China on Taiwan
交通=[jiāotōng] intercourse,commutation,transportation,communication,commuting,traffic,traffic_light,liaison man,communications,dealings,liaison
或是=[huòshì] conj.: or,perhaps
条件=[tiáojiàn] mood,formula,conditional,precondition,prerequisite,requisition,factor,qualification,requirement,stipulation,proviso,circumstances,provision,term,reservation,if,condition
政府=[zhèngfǔ] sirkar,state,country,nation,governmental,body politic,government,administration,civil order,polity,commonwealth,regime,res publica,land
本身=[běnshēn] per se,self,oneself,identity,itself
发生=[fāshēng] happen,occur,take place
提供=[tígōng] feed,offer,put_up,afford,proffer,set_up,capitalize,bring_forward,sponsor,extend,ply,provision,sustain,equip,supply,cough_up,bear,render,furnish,cater,billet,provide
工作=[gōngzuò] work
逐渐=[zhújiàn] step_by_step,by degrees,gradually
不会=[búhuì] won't
全部=[quánbù] lot,aggregate,all,gross,entirety,allness,shebang,caboodle,complete,bunch,sum,total,gamut,entire,det.: all,totality,whole
不再=[búzài] no more/longer
举行=[jǔxíng] hold (meeting/etc.)
相关=[xiāngguān] cognate,relational,interrelate,associated,be interrelated,relevant,related,be mutually related
报告=[bàogào] report,speech,(student) term paper
所以=[suǒyǐ] conj.: so,therefore,as a result
报导=[bàodǎo] report,
特殊=[tèshū] exceptional,special,particular; peculiar,distinctive
居民=[jūmín] municipality,population,citizen,denizen,townie,people,dweller,populace,residenter,resident,towny,inhabitant,habitant,liver
执行=[zhíxíng] carry out,execute
设备=[shèbèi] installation,set,device,appointment,plant,fixing,system,appliance,fixture,fitting,accommodation,fitment,finishing,unit,furnishings,materiel,contrivance,paraphernalia,facilities,rig,equipage,setout,facility,fixings,equipment
关心=[guānxīn] be concerned about
提高=[tígāo] raise,heighten,enhance,increase,improve
了解=[liǎojiě] understand,comprehend,find out,acquaint oneself with
结果=[jiéguǒ] finally
台湾=[táiwān] Taiwan
科学=[kēxué] ology,scientific,science,scientific knowledge
中国=[zhōngguó] Cathay,China,china
负责=[fùzé] preside,be responsible for,see,entail,sponsor,be in charge of,blame,answer,undertake,liable,respond
追求=[zhuīqiú] seek, pursue, woo, court
这样=[zhèyàng] so,such,like this,this way
目标=[mùbiāo] polestar,objective,goal,bourn,object,meaning,aim,end point,target,cause,landmark,butt,lodestar,bull's eye,mark,tee,cynosure,end,bell ringer,loadstar,quaesitum,destination
国中=[guózhōng] middle school,junior high school
制作=[zhìzuò] make,manufacture
举办=[jǔbàn] conduct,hold,run
有效=[yǒuxiào] run,stand,valid,effective,efficacious,avail,make,hold
丰富=[fēngfù] rich,abundant,plentiful
不可=[bùkě] cannot,should not,must not
人民=[rénmín] multitude,citizen,quarter,Volk,hoi polloi,subject,people,nationals,masses,the people,mass,demotic
一样=[yīyàng] same,equal,similar
造成=[zàochéng] make_for,give rise to,create,set_up,strike,creation,cause,contribute,bring_about,procure,give,bring about,cut_out,necessitate,shape,present,bring_forth,generate,yield,make,breed
关心=[guānxīn] be concerned about
发现=[fāxiàn] find,discover
通常=[tōngcháng] normal,commonly,customarily,more often than not,general,usual,on average,as a rule,ordinarily,mostly,as usual,typically,generally,normally,by and large,unremarkably,on the average,usually
观念=[guānniàn] conception,intension,theory,philosophy,idolum,connotation,idea,sense,presentation,notion,concept,construct,intellection,presentment,thought,notional,conceit
创造=[chuàngzào] create,produce,bring about
建立=[jiànlì] establish,set up,found
说明=[shuōmíng] explain,illustrate,show
感觉=[gǎnjué] sense perception,feeling
提出=[tíchū] put forward,pose,raise
正确=[zhèngquè] correct,true,exact,proper,right
成功=[chénggōng] succeed
特别=[tèbié] unusual,specially
这么=[zhèmo] so,such,this way,like this
表达=[biǎodá] express,convey,voice
甚至=[shènzhì] even (to the point of),so much so that
在于=[zàiyū] be at,on,lie,in,depend on,lie_in,rest with,lie in,be determined by,consist_in,consist in
人物=[rénwù] character,persona,original,spirit,figure painting,character in literature,figure,person in literature,person,fish,personage,personality
一切=[yīqiè] det.: everything, every
然而=[ránér] conj.: even so,but
民族=[mínzú] tribe,citizenry,ethnos,ethnic minority/group,race,nationality,group,Volk,nation,folk,people,ethnic group,ethnographer,family,ethnic minority
出来=[chūlái] come forward,issue,come up,step up,step to the fore,out (toward one),come_out,pop out,come out,rise,come to the fore,step forward,emergence,come forth,emerge
力量=[lìliàng] fibre,strength,potency,ability,guts,kick,cogency,point,dint,energy,mightiness,physical strength,demon,force,punch,whiz,tooth,might,forcefulness,exercise,fiber,powerfulness,lift,pith,leverage,agency,push,muscle,power
国小=[guóxiǎo] primary/elementary school,primary school
缺乏=[quēfá] be short of, lack
资源=[zīyuán] resource,natural resources,mine,resources
小朋友=[xiǎopéngyǒu] child (adult address to child),little boy,children,little boy/girl,girl,little girl,little boy or girl,child
一直=[yīzhí] e'er,away,continuously,all the way,right,forever,all_along,always,the whole way,all along,straight,slap,through,ever,evermore
安排=[ānpái] arrange,plan,fix up,provide (meals/etc.)
强调=[qiángdiào] underscore,spotlight,place emphasis on,point_up,highlight,point,point up,enforce,emphasise,urge,underline,overstress,give emphasis to,play up,keynote,insist,punctuate,accent,betone,foreground,emphasize,emphatic,stress,set off,overemphasize,accentuate,bring out
真的=[zhēnde] really,truly,indeed
经营=[jīngyíng] manage,run,engage in
学者=[xuézhě] academic,literate,pandit,letters,litterateur,learned person,literati,philomath,pundit,academician,faculty member,scholar,bookman,clerk,student,scholarly person,man of letters,man of learning,speleologist,doctor,clerisy,initiate,swami,punditry,savant,learned man,sophist
找到=[zhǎodào] light upon,find,discover,run_down,founded,regain,strike,come upon,come across,run down,trace,turn_up,happen upon,get,chance on,chance upon
规划=[guīhuà] program,plan
总是=[zǒngshì] always
充满=[chōngmǎn] swarm,be brimming,inhabit,be brimming with,teem,crawl,fill,lard,pullulate with,brim,be permeated with,bathe,be filled with,permeated with,abound in,implement,exuberate,fill up,flow,abound,burst,perfuse,foam,bristle,crackle,inform,pervade,be imbued with,simmer,glut,teem in,permeate,congest,be full of,reek,charge,suffuse,pullulate,overfill,swell
无法=[wúfǎ] nohow,unable to,unable,cannot
随着=[suízhe] along with,in the wake of,in pace with
作业=[zuòyè] school assignment,work,task,operation,production
应该=[yīnggāi] should,ought to
语言=[yǔyán] linguistic communication,lingual,language,idiom,tongue,oral communication,speech,perspicuity,lingo,contumely,Fortran,parole,natural language,spoken language,linguistic process
别人=[biérén] others,other people,another person
科技=[kējì] technology,tech,engineering science,applied science,science and technology,technological,engineering
出现=[chūxiàn] appear,arise,emerge
标准=[biāozhǔn] standard,criterion
改革=[gǎigé] reform
改变=[gǎibiàn] change,transform
改善=[gǎishàn] improve,perfect
能力=[nénglì] department,potency,ability,acquisition,acquirement,capacity,performance,oomph,sufficiency,energy,competence,accomplishment,size,might,faculty,hand,coequal,efficiency,inner resources,capability,giftie,attainment,capableness,zip,skill,competency,power
部份=[bùfèn] composition,segment,section,side,portion,slice,proportion,part,det.: part,share,component,division,phase,place,piece
改革=[gǎigé] reform
重新=[chóngxīn] over_again,newly,afresh,anew,again
不论=[búlùn] conj.: no matter how/who/what/etc.
使用=[shǐyòng] use,employ,apply
于是=[yūshì] conj.: thereupon,hence,consequently,as a result
申请=[shēnqǐng] apply for
妈妈=[māmā] mummy,mammy,ma,mother,mamma,mum,mommy,female parent,mom,Mama,mater,mama,momma
继续=[jìxù] go,resume,keep_on,abide,come on,persist in,extend,run_on,run on,carry_on,stretch,sustain,pursue,keep going,continuance,get_along,get_on,remain,continue,keep_up,go ahead,keep up,come up,continuation,hold,carry,run,go_on,maintain,go on,bide,plow ahead,hold_on,piece,restart
教育=[jiàoyū] education
加以=[jiāyǐ] handle; treat (used before polysyllabic verbs or verbal nouns)
父亲=[fùqīn] parent,father,pere,Pa,begetter,governor,abba,male parent,pater,guv
所谓=[suǒwèi] so-called
工业=[gōngyè] industrial,industry
那么=[nàmo] like that,in that way
产品=[chǎnpǐn] baby,brand,output,product,produce,end product,merchandise,fruitage,growth,manufacture,wares,production
肯定=[kěndìng] affirm,approve,regard as positive
什么=[shéme] anything,what
精神=[jīngshén] god,guts,heart,pneuma,consciousness,vigor,life,energy,vim,courage,esprit,moral,get-up-and-go,ginger,vitality,Psyche,psyche,spunk,gumption,juice,sand,mind,mental,mens,mickey,mettle,nature,grit,oomph,genius,vigour,substance,psychic,backbone,nous,nerve,pazazz,essence,pep,spirit,inward,drive,push,soul,gist
国际=[guójì] international
已经=[yǐjīng] already
面对=[miànduì] face up,stand up,face,look_out_on,confront,front,affront,envisage,accost,breast
可是=[kěshì] conj.: but, yet, however
小组=[xiǎozǔ] squad,section,unit,group
鼓励=[gǔlì] encourage,urge
战争=[zhànzhēng] war,warfare
进行=[jìnxíng] be in progress,go on,carry on/out
你们=[nǐmen] you,you (plural),you-all
结合=[jiéhé] combine,unite,integrate,link,be joined in wedlock
欧洲=[ōuzhōu] Europe
而且=[érqiě] conj.: furthermore,and
值得=[zhíde] be worth,merit,pay,rate,behove,worthwhile,worth,worthy,deserve,call_for,command
校长=[xiàozhǎng] prexy,head,principal,headteacher,schoolmaster,master,warden,president,beak,rector,superintendent,director,head teacher,preceptor,headmaster,chancellor,school principal
方向=[fāngxiàng] path,set,directional,aspect,tenor,course,lay,exposure,way,range,aim,trend,direction,bearing,orientation,hand,tack,way of life,quarter,channel,line,heading
例如=[lìrú] for instance/example,e.g.,such as
同学=[tóngxué] class fellow,fellow student,condisciple,classmate,schoolmate,schoolfellow,form of address used in speaking to a student
安全=[ānquán] safe,secure
选择=[xuǎnzé] select,opt
发展=[fāzhǎn] develop,expand,grow
知道=[zhīdào] tell,have,ken,understand,infer,wis,learn,cognize,gather,know,be aware of,wise up,savvy,mind,realize